1111111111
10000E0001
100P000001
1000000C01
1111111111