1111111111
1E000CP001
1000000001
1111111111