11111
1P0C1
100E1
10001
11111
