1111111111
1CEP0000C1
1000000111
1111111111