111111
100C01
1E0001
1000P1
111111
