111111111111111111111
1E000000C000000001111
1000C000000C00C001111
1000000C0000000001111
100C0000P00C00C001111
100000000C00000001111
1000C0000000C0C001111
100000000000000001111
111111111111111111111
111111111111111111111
111111111111111111111