1111111111
100000E001
100P000001
1000000C01
1111111111